24 12
7 0
....#....#....#....#....
.....##.................
....#####...............
....######..............
.....##A................
........................
........................
.........#..............
........###.............
.......#####B...........
........####............
.........#..............
4
. 
#
A
B